111111111111111
1C010000000C001
100001111100001
1P0011E00000C01
111111111111111
